{
	"open": false,
	"completed": false,
	"tiledMap": "terrain/prototype.tmx",
	"towers": [],
	"traps": [],
	"walls": [],
	"spawners": [
		{
			"x": 3,
			"y": 1,
			"texture": "textures/world/spawner1.png"
		},
		{
			"x": -1,
			"y": 9,
			"texture": null
		},
		{
			"x": 22,
			"y": 8,
			"texture": null
		}
	],
	"waves": [
		{
			"enemy": {
				"speed": 1.0,
				"name": "Green Slime",
				"hitPoints": 10,
				"spritesheet": "textures/enemies/green_slime.png",
				"armor": 1
			},
			"size": 15
		},
		{
			"enemy": {
				"speed": 1.4,
				"name": "Blue Slime",
				"hitPoints": 12,
				"spritesheet": "textures/enemies/blue_slime.png",
				"armor": 1.4
			},
			"size": 17
		},
		{
			"enemy": {
				"speed": 2,
				"name": "",
				"hitPoints": 8,
				"spritesheet": "textures/enemies/yellow_slime.png",
				"armor": 0.8
			},
			"size": 14
		},
		{
			"enemy": {
				"speed": 1.1,
				"name": "",
				"hitPoints": 15,
				"spritesheet": "textures/enemies/red_slime.png",
				"armor": 2.2
			},
			"size": 10
		}
	],
	"path": [
		[0, 0, 0, 0, 0, 0, 0, 0, 0, 0, 0, 0, 0, 0, 0, 0, 0, 0, 0, 0, 0, 0, 0, 0],
		[0, 0, 0, 0, 0, 0, 0, 0, 0, 0, 0, 0, 0, 0, 0, 0, 0, 0, 0, 0, 0, 0, 0, 0],
		[0, 0, 0, 0, 0, 0, 0, 0, 0, 0, 0, 0, 0, 0, 0, 0, 0, 0, 0, 0, 0, 0, 0, 0],
		[0, 0, 0, 0, 0, 0, 0, 0, 0, 0, 0, 1, 1, 1, 1, 2, 0, 0, 0, 0, 0, 0, 0, 0],
		[0, 0, 0, 0, 0, 0, 0, 0, 0, 0, 0, 1, 0, 0, 0, 0, 0, 0, 0, 0, 0, 0, 0, 0],
		[3, 1, 1, 1, 1, 0, 0, 0, 0, 0, 0, 1, 0, 0, 0, 0, 0, 0, 0, 0, 0, 0, 0, 0],
		[0, 0, 0, 0, 1, 0, 0, 0, 0, 1, 1, 1, 1, 1, 0, 0, 0, 0, 0, 1, 1, 1, 1, 3],
		[0, 0, 0, 0, 1, 0, 0, 0, 0, 1, 0, 0, 0, 1, 0, 0, 0, 0, 0, 1, 0, 0, 0, 0],
		[0, 0, 0, 0, 1, 1, 1, 1, 1, 1, 0, 0, 0, 1, 1, 1, 1, 0, 0, 1, 0, 0, 0, 0],
		[0, 0, 0, 0, 0, 0, 0, 0, 0, 1, 0, 0, 0, 1, 0, 0, 1, 0, 0, 1, 0, 0, 0, 0],
		[0, 0, 0, 0, 0, 0, 0, 0, 0, 1, 1, 1, 1, 1, 0, 0, 1, 1, 1, 1, 0, 0, 0, 0],
		[0, 0, 0, 0, 0, 0, 0, 0, 0, 0, 0, 1, 0, 0, 0, 0, 0, 0, 0, 0, 0, 0, 0, 0],
		[0, 0, 0, 0, 0, 0, 0, 0, 0, 0, 0, 1, 0, 0, 0, 0, 0, 0, 0, 0, 0, 0, 0, 0],
		[0, 0, 0, 0, 3, 1, 1, 1, 1, 1, 1, 1, 0, 0, 0, 0, 0, 0, 0, 0, 0, 0, 0, 0],
		[0, 0, 0, 0, 0, 0, 0, 0, 0, 0, 0, 0, 0, 0, 0, 0, 0, 0, 0, 0, 0, 0, 0, 0],
		[0, 0, 0, 0, 0, 0, 0, 0, 0, 0, 0, 0, 0, 0, 0, 0, 0, 0, 0, 0, 0, 0, 0, 0]
	]
}